addClass()	Adds one or more class names to selected elements
after()	Inserts content after selected elements
append()	Inserts content at the end of selected elements
attr()	Sets or returns attributes/values of selected elements
before()	Inserts content before selected elements
clone()	Makes a copy of selected elements
css()	Sets or returns one or more style properties for selected elements
empty()	Removes all child nodes and content from selected elements
html()	Sets or returns the content of selected elements
prepend()	Inserts content at the beginning of selected elements
prop()	Sets or returns properties/values of selected elements
remove()	Removes the selected elements (including data and events)
removeAttr()	Removes one or more attributes from selected elements
removeClass()	Removes one or more classes from selected elements
removeProp()	Removes a property set by the prop() method
text()	Sets or returns the text content of selected elements
toggleClass()	Toggles between adding/removing one or more classes from selected elements
unwrap()	Removes the parent element of the selected elements
val()	Sets or returns the value attribute of the selected elements (for form elements)
wrap()	Wraps HTML element(s) around each selected element